+ +-+-+-+-+-+
|#|# # # #| |
+ + +-+-+ + +
|#|#|   |# #|
+ + + +-+-+ +
|#|#|     |#|
+ + +-+ + + +
|#|#|   | |#|
+ + + +-+-+ +
|# #|# # # #|
+-+-+ +-+-+-+
|    # # # #|
+-+-+-+-+-+ +
