+ +-+-+-+-+-+
|# # #| |   |
+-+-+ + + + +
|   |#|   | |
+ +-+ + +-+ +
|# # #| |# #|
+ +-+-+-+ + +
|#|  # # #|#|
+ + + +-+-+ +
|#| |#|   |#|
+ +-+ + +-+ +
|# # #|    #|
+-+-+-+-+-+ +
